***************
*@ *   *     @*
** * * * ******
*  * * *      *
* **** ****** *
*             *
** ********** *
*    *   * ** *
****   *   *@ *
* @******* ****
* ***    *   **
* *   *    *  *
* * * *** *** *
*   *   * *@  *
***************