***************
*M *   *      *
** * * * ******
*  * * *      *
* **** ****** *
*             *
** ********** *
*    *   * ** *
****   *   *  *
*  ******* ****
* ***    *   **
* *   *    *  *
* * * *** *** *
*   *   * *G  *
***************